[
  { "一": "いち" },
  { "番": "ばん" },
  { "大": "だい" },
  { "学": "がく" },
  { "女": "おんな" },
  { "学": "がく" },
  { "生": "せい" },
  { "男": "おとこ" },
  { "学": "がく" },
  { "生": "せい" },
  { "話": "はな" },
  { "男": "おとこ" },
  { "学": "がく" },
  { "生": "せい" },
  { "後": "あと" },
  { "何": "なに" },
  { "中": "なか" },
  { "村": "むら" },
  { "掲": "けい" },
  { "示": "じ" },
  { "板": "ばん" },
  { "貼": "は" },
  { "他": "ほか" },
  { "僕": "ぼく" },
  { "会": "かい" },
  { "場": "じょう" },
  { "準": "じゅん" },
  { "備": "び" },
  { "前": "まえ" },
  { "日": "じつ" },
  { "当": "とう" },
  { "日": "じつ" },
  { "用": "よう" },
  { "表": "ひょう" },
  { "欲": "ほ" },
  { "今": "こん" },
  { "週": "しゅう" },
  { "中": "ちゅう" },
  { "願": "ねが" },
  { "番": "ばん" },
  { "大": "だい" },
  { "事": "じ" },
  { "当": "とう" },
  { "日": "じつ" },
  { "配": "くば" },
  { "資": "し" },
  { "料": "りょう" },
  { "部": "ぶ" },
  { "発": "はっ" },
  { "表": "ぴょう" },
  { "者": "しゃ" },
  { "方": "かた" },
  { "資": "し" },
  { "料": "りょう" },
  { "全": "ぜん" },
  { "部": "ぶ" },
  { "集": "あつ" },
  { "忙": "いそが" },
  { "方": "かた" },
  { "私": "わたし" },
  { "発": "はっ" },
  { "表": "ぴょう" },
  { "者": "しゃ" },
  { "資": "し" },
  { "料": "りょう" },
  { "送": "おく" },
  { "連": "れん" },
  { "絡": "らく" },
  { "集": "あつ" },
  { "次": "じ" },
  { "第": "だい" },
  { "週": "しゅう" },
  { "明": "あ" },
  { "出": "だ" },
  { "男": "おとこ" },
  { "学": "がく" },
  { "生": "せい" },
  { "後": "あと" },
  { "何": "なに" }
]
