{
  "森": "もり",
  "僕": "ぼく",
  "来": "らい",
  "週": "しゅ",
  "引": "ひっ",
  "越": "こす",
  "今": "いま",
  "使": "つかっ",
  "冷": "れい",
  "蔵": "ぞう",
  "庫": "こ",
  "人": "ひと",
  "探": "さがし",
  "誰": "だれ",
  "知": "しら",
  "心": "こころ",
  "当": "あたり",
  "確": "たしか",
  "粗": "そ",
  "大": "だ",
  "出": "だせ",
  "法": "ほう",
  "律": "りつ",
  "時": "とき",
  "手": "てつ",
  "続": "づき",
  "市": "し",
  "役": "やく",
  "所": "しょ",
  "連": "れん",
  "絡": "らく",
  "会": "かい",
  "社": "しゃ",
  "事": "じ",
  "前": "ぜ",
  "言": "いっ",
  "日": "じつ",
  "回": "かい",
  "収": "しゅ",
  "聞": "きい",
  "簡": "かん",
  "単": "たん",
  "間": "か"
}